################################################################################
#                                                                              #
#                                                                              #
#                                                                              #
#                                                                              #
#                                                                              #
#                                                                              #
#                                                                              #
#                  __   __           __        ___       _                     #
#                  \ \ / /__  _   _  \ \      / (_)_ __ | |                    #
#                   \ V / _ \| | | |  \ \ /\ / /| | '_ \| |                    #
#                    | | (_) | |_| |   \ V  V / | | | | |_|                    #
#                    |_|\___/ \__,_|    \_/\_/  |_|_| |_(_)                    #
#                                                                              #
#                                                                              #
#                                                                              #
#                           Thank you for playing!                             #
#                                                                              #
#                                                                              #
#                                                                              #
#                                                                              #
################################################################################
